300 300 300 300 300 300 300 300 300 300 300 300 300 300 300 300 300 300 300 300
300 300 300 300 300 300 300 300 300 300 300 300 300 300 300 300 300 300 300 51
300 300 300 300 300 300 300 300 300 300 300 300 300 300 300 300 300 458 459 486
300 300 431 432 458 459 485 486 485 486 431 432 431 459 458 432 485 51 51 432
300 300 432 459 51 431 459 485 458 51 486 432 458 51 432 431 486 459 300 300
300 300 51 486 300 300 300 300 300 300 300 300 300 300 300 300 300 300 300 218
300 300 459 485 300 300 83 327 326 327 326 327 326 327 326 327 326 327 326 218
300 300 486 459 300 300 219 219 219 219 219 219 218 218 219 219 218 219 218 219
300 300 431 51 300 300 300 300 300 300 300 300 300 300 300 300 300 300 300 414
300 300 485 486 300 300 300 300 300 300 300 300 300 300 300 300 300 300 300 414
300 300 432 458 300 300 300 300 300 300 300 300 300 300 300 300 300 300 300 414
300 300 459 485 300 300 300 300 300 300 300 300 300 300 300 300 300 300 300 414
300 300 51 456 300 300 300 300 300 300 300 300 300 300 300 300 300 300 300 414
300 300 431 486 300 300 300 300 300 300 300 300 300 300 300 300 300 300 300 414
300 300 459 432 300 300 300 300 300 300 300 300 300 300 300 300 300 300 300 414
485 432 431 51 300 300 300 300 300 300 300 300 300 300 300 300 300 300 300 414
486 431 486 300 300 300 300 300 300 300 300 300 300 300 300 300 300 300 414 414
300 300 300 300 300 300 300 300 300 300 300 300 300 300 300 300 300 300 414 414
300 300 300 300 300 300 300 300 300 300 300 300 300 300 300 300 300 300 414 414
300 300 300 300 300 300 300 300 300 300 300 300 300 300 300 300 300 300 414 414





