0 0 0 0 0 0 0 0 0 0 0 0 0 0 0 0 0 0 23 24 24 76 0 0 52 0 0 0 0 301 0 0 0 0 0 0 0 0 0 0 0 0 413 0 0 0 0 0 0 0
0 0 0 0 0 0 0 0 0 0 0 0 0 0 0 0 23 24 76 0 0 0 0 0 52 0 0 0 0 301 0 0 0 0 0 0 0 0 0 0 0 386 451 0 0 0 0 0 0 0
0 23 24 24 24 24 24 24 24 24 24 24 24 24 24 24 76 0 0 0 0 0 0 0 52 167 0 0 0 328 0 0 0 0 0 0 0 0 386 450 450 451 0 0 0 0 0 0 0 0
0 50 0 0 0 0 0 0 0 0 0 0 0 0 0 0 0 0 0 0 20 78 78 78 79 301 0 0 0 220 0 0 0 0 0 0 0 0 424 0 0 0 0 0 0 0 0 0 0 0
0 50 0 0 0 0 0 0 0 0 0 0 0 0 0 0 0 0 20 78 79 0 0 0 0 301 0 0 0 220 0 0 0 0 0 386 450 450 451 0 0 0 0 0 0 0 0 0 0 0
0 50 0 0 20 78 78 78 78 78 78 78 78 78 78 78 78 78 79 167 328 0 0 0 0 354 354 353 354 355 0 0 0 0 386 451 0 0 0 0 0 0 0 0 0 0 0 0 0 0
0 50 0 0 52 0 167 0 0 0 0 0 0 0 0 0 0 0 0 328 0 0 0 0 0 220 0 0 0 0 0 0 386 387 451 0 0 0 0 0 0 0 0 0 0 0 0 0 0 0
0 50 0 0 52 0 301 0 0 0 0 0 0 0 0 0 0 0 0 220 0 0 0 0 0 220 0 0 0 386 387 387 451 0 0 0 0 0 0 0 0 0 0 0 0 0 0 0 0 0
0 50 0 0 52 0 110 111 110 111 110 111 110 111 110 111 110 111 110 301 354 353 354 353 354 355 0 386 387 451 0 0 0 0 0 0 0 0 0 0 0 0 0 0 0 0 0 0 0 0
0 50 0 0 52 0 301 0 0 0 0 424 0 0 0 0 0 0 0 301 0 0 0 0 0 386 387 451 0 0 0 0 0 0 0 0 0 0 0 0 0 0 0 0 0 0 0 0 0 0
0 50 0 0 52 0 301 0 0 386 450 451 0 0 0 0 0 0 0 301 0 0 0 0 386 451 0 0 0 0 0 0 0 0 0 0 0 0 0 0 0 0 0 0 0 0 0 0 0 0
0 50 0 0 52 0 301 0 0 413 0 0 0 0 0 0 0 0 0 301 0 0 0 0 424 0 0 0 0 0 0 0 0 0 0 0 0 0 0 0 0 0 0 0 0 0 0 0 0 0
0 50 0 0 52 0 301 0 0 413 0 0 0 0 0 0 0 0 0 387 387 388 0 386 451 0 0 0 0 0 0 0 0 0 0 0 0 0 0 0 0 0 0 0 0 0 0 0 0 0
386 50 0 0 52 0 301 0 386 451 0 0 0 0 0 0 0 0 89 90 0 449 387 416 0 0 0 0 0 0 0 0 0 0 0 0 0 0 0 0 0 0 0 0 0 0 0 0 0 0
75 76 0 0 52 0 301 0 413 0 0 0 0 0 0 0 0 0 116 117 0 0 0 416 0 0 0 0 0 0 0 0 0 0 0 0 0 0 0 0 0 0 0 0 0 0 0 0 0 0
0 0 0 0 52 0 301 450 451 0 0 0 0 0 0 0 0 0 143 144 0 0 0 416 0 0 0 0 0 0 0 0 0 0 0 0 0 0 0 0 0 0 0 0 0 0 0 0 0 0
0 0 0 20 79 0 301 0 0 0 0 0 0 0 0 0 0 0 167 328 0 0 0 443 444 400 0 0 0 0 0 0 0 0 0 0 0 0 0 0 0 0 0 0 0 0 0 0 0 0
21 21 21 79 0 0 301 0 0 0 0 0 0 0 0 0 0 0 301 355 0 0 0 0 0 427 0 0 0 0 0 0 0 0 0 0 0 0 0 0 0 0 0 0 0 0 0 0 0 0
0 0 0 0 0 0 301 0 0 0 0 0 0 0 0 0 0 0 301 0 0 0 0 0 0 443 400 0 0 0 0 0 0 0 0 0 0 0 0 0 0 0 0 0 0 0 0 0 0 0
0 0 0 0 0 0 301 0 0 0 0 0 0 0 0 0 0 0 301 0 0 0 0 0 0 0 427 0 0 0 0 0 0 0 0 0 0 0 0 0 0 0 0 0 0 0 0 0 0 0
