300 300 300 300 300 300 300 300 300 300 300 300 300 300 300 300 300 300 300 300 300 300 51 431 300 300 300 300 300 423 423 423 423 423 423 423 423 423 423 423 423 423 417 417 417 417 417 417 30 30
300 300 300 300 300 300 300 300 300 300 300 300 300 300 300 300 300 300 300 51 486 458 458 459 300 300 300 300 300 423 423 423 423 423 423 423 423 423 423 423 423 417 417 417 417 417 417 30 30 30
300 300 300 300 300 300 300 300 300 300 300 300 300 300 300 300 300 458 459 486 459 51 486 458 300 218 327 326 327 423 423 423 423 423 423 423 423 423 417 417 417 417 417 417 417 30 30 30 30 30
300 300 431 432 458 459 485 486 485 486 431 432 431 459 458 432 485 51 51 432 300 300 300 300 300 218 218 218 218 423 423 423 423 423 423 423 423 423 417 417 417 417 417 417 30 30 30 30 30 30
300 300 432 459 51 431 459 485 458 51 486 432 458 51 432 431 486 459 300 300 300 300 300 300 300 219 218 218 218 423 423 423 423 423 423 417 417 417 417 417 417 417 417 30 30 30 30 30 30 30
300 300 51 486 300 300 300 300 300 300 300 300 300 300 300 300 300 300 300 218 327 326 326 327 326 423 423 423 423 423 423 423 423 423 417 417 417 417 417 417 417 30 30 30 30 30 30 30 30 30
300 300 459 485 300 300 83 327 326 327 326 327 326 327 326 327 326 327 326 218 219 218 219 219 219 423 423 423 423 423 423 423 417 417 417 417 417 417 417 417 30 30 30 30 30 30 30 30 30 30
300 300 486 459 300 300 219 219 219 219 219 219 218 218 219 219 218 219 218 219 218 219 218 219 218 423 423 423 423 417 417 417 417 417 417 417 417 30 30 30 30 30 30 30 30 30 30 30 30 30
300 300 431 51 300 300 414 414 414 414 414 414 300 300 300 300 300 300 300 218 423 423 423 423 423 423 423 417 417 417 417 417 417 417 417 30 30 30 30 30 30 30 30 30 30 30 30 30 30 30
300 300 485 486 300 300 414 414 414 414 414 300 300 300 300 300 300 300 300 414 423 423 423 423 423 417 417 417 417 417 417 417 30 30 30 30 30 30 30 30 30 30 30 30 30 30 30 30 30 30
300 300 432 458 300 300 414 414 414 300 300 300 300 300 300 300 300 300 300 414 423 423 423 423 417 417 417 30 30 30 30 30 30 30 30 30 30 30 30 30 30 30 30 30 30 30 30 30 30 30
300 300 459 485 300 300 414 414 414 300 300 300 300 300 300 300 300 300 300 414 423 423 423 423 417 417 30 30 30 30 30 30 30 30 30 30 30 30 30 30 30 30 30 30 30 30 30 30 30 30
300 300 51 458 300 300 414 414 414 300 300 300 300 300 300 300 300 300 300 417 417 417 423 417 417 417 30 30 30 30 30 30 30 30 30 30 30 30 30 30 30 30 30 30 30 30 30 30 30 30
300 300 431 486 300 300 414 414 300 300 300 300 300 300 300 300 300 300 300 417 417 417 417 417 417 30 30 30 30 30 30 30 30 30 30 30 30 30 30 30 30 30 30 30 30 30 30 30 30 30
300 300 459 432 300 300 414 414 300 300 300 300 300 300 300 300 300 300 300 417 417 417 417 417 417 30 30 30 30 30 30 30 30 30 30 30 30 30 30 30 30 30 30 30 30 30 30 30 30 30
485 432 431 51 300 300 414 300 300 300 300 300 300 300 300 300 300 300 300 417 417 417 417 417 30 30 30 30 30 30 30 30 30 30 30 30 30 30 30 30 30 30 30 30 30 30 30 30 30 30
486 431 486 300 300 300 300 300 300 300 300 300 300 300 300 300 300 300 84 417 417 417 417 417 30 30 30 30 30 30 30 30 30 30 30 30 30 30 30 30 30 30 30 30 30 30 30 30 30 30
300 300 300 300 300 300 300 300 300 300 300 300 300 300 300 300 300 300 84 417 417 417 417 417 417 30 30 30 30 30 30 30 30 30 30 30 30 30 30 30 30 30 30 30 30 30 30 30 30 30
300 300 300 300 300 300 300 300 300 300 300 300 300 300 300 300 300 300 417 417 417 417 417 417 417 30 30 30 30 30 30 30 30 30 30 30 30 30 30 30 30 30 30 30 30 30 30 30 30 30
300 300 300 300 300 300 300 300 300 300 300 300 300 300 300 300 300 83 417 417 417 417 417 417 417 417 30 30 30 30 30 30 30 30 30 30 30 30 30 30 30 30 30 30 30 30 30 30 30 30
300 300 300 300 300 300 300 300 300 300 300 300 300 300 300 300 300 327 326 327 326 327 326 327 326 327 56 84 30 30 30 83 230 229 230 229 230 229 83 30 30 30 30 30 30 30 30 30 30 83
300 300 300 300 300 300 300 300 300 300 300 300 300 300 300 300 300 84 84 84 84 84 84 84 84 84 84 84 56 57 56 83 30 30 30 30 30 30 83 30 30 30 30 30 30 30 30 30 30 83
300 300 300 300 300 300 300 300 300 300 300 300 300 300 300 300 300 407 407 407 407 407 407 407 407 407 407 407 84 84 84 83 238 238 238 238 238 238 83 30 30 30 30 30 30 30 30 30 30 472
300 300 300 300 300 300 300 300 300 300 300 300 300 300 300 300 300 407 407 407 407 407 407 407 407 407 407 407 407 407 407 407 407 407 407 407 407 407 407 30 30 30 30 30 30 30 30 30 30 472
300 300 300 300 300 300 300 300 300 300 300 300 300 300 300 300 300 407 407 407 407 407 407 407 407 407 407 407 407 407 407 407 407 407 407 407 407 407 407 83 30 30 30 30 30 30 30 30 30 472
300 300 300 300 300 300 300 300 300 300 300 300 300 300 300 300 300 407 407 407 407 407 407 407 407 407 407 407 407 407 407 407 407 407 407 407 407 407 407 83 30 30 30 30 30 30 30 30 30 472
300 300 300 300 300 218 327 327 300 300 300 300 300 300 300 300 300 407 407 407 407 407 407 407 407 407 407 407 407 407 407 407 407 407 407 407 407 407 407 407 30 30 30 30 30 30 30 30 30 472
300 300 300 218 327 218 218 218 300 300 300 300 300 300 300 300 300 407 407 407 407 407 407 407 407 407 407 407 407 407 407 407 407 407 407 407 407 407 407 407 56 56 83 30 30 30 30 83 56 472
327 327 327 218 218 218 218 300 300 300 300 300 300 300 300 300 83 407 407 407 407 407 407 407 407 407 407 407 407 407 407 407 407 407 407 407 407 407 407 407 83 83 83 56 56 56 56 83 83 472
218 218 218 218 218 218 218 300 300 300 300 300 300 300 300 300 83 407 407 407 407 407 407 407 407 407 407 407 407 407 407 407 407 407 17 18 69 18 19 407 44 472 472 83 83 83 83 472 472 472
218 218 218 218 218 469 469 327 218 300 300 300 300 300 300 300 83 407 407 407 407 407 407 407 407 407 407 407 407 407 17 18 69 69 70 472 472 472 68 69 70 472 472 472 472 472 472 472 472 472
218 218 218 469 469 469 469 218 218 300 300 300 300 218 327 327 407 407 407 407 407 407 407 407 407 407 407 407 407 17 70 472 472 472 472 472 472 472 472 472 472 472 472 472 472 472 472 472 472 472
469 469 469 469 8 66 66 218 218 327 327 327 327 218 218 218 407 407 407 407 407 407 407 407 407 407 407 407 407 43 472 472 472 472 472 472 472 472 472 472 472 472 472 472 472 472 472 472 472 472
469 469 469 469 40 472 437 407 407 218 218 218 218 218 218 218 18 19 407 407 407 407 407 407 407 407 407 407 17 70 472 472 472 472 472 472 472 472 472 472 472 472 472 472 472 472 472 472 472 472
469 469 467 469 40 472 437 407 407 218 218 218 218 407 407 439 472 46 407 407 407 407 407 407 407 407 407 407 43 472 472 472 472 472 472 472 472 472 472 472 472 472 472 472 472 472 472 472 472 472
468 469 469 469 40 472 437 407 407 407 407 407 407 407 407 439 472 46 407 407 407 407 407 407 407 407 407 407 44 472 472 472 472 472 472 472 472 472 472 472 472 472 472 472 472 472 472 472 472 472
467 469 469 469 40 472 464 331 407 407 407 407 407 407 407 439 472 46 407 407 407 407 407 407 407 407 407 17 70 472 472 472 472 472 472 472 472 472 472 472 472 472 472 472 472 472 472 472 472 472
469 469 469 469 40 472 472 358 407 407 407 407 407 407 329 466 472 68 19 407 407 407 407 407 407 407 407 43 472 472 472 472 472 472 472 472 472 472 472 472 472 472 472 472 472 472 472 472 472 472
469 469 469 469 40 472 472 464 331 407 407 407 329 465 466 472 472 472 68 19 407 407 407 407 407 407 407 43 472 472 472 472 472 472 472 472 472 472 472 472 472 472 472 472 472 472 472 472 472 472
469 469 469 469 40 472 472 472 464 465 465 465 466 472 472 472 472 472 472 68 19 407 407 407 407 407 407 44 472 472 472 472 472 472 472 472 472 472 472 472 472 472 472 472 472 472 472 472 472 472
469 469 469 468 469 12 13 472 472 472 472 472 472 472 472 472 472 472 472 472 68 19 407 407 407 407 17 70 472 472 472 472 472 472 472 472 472 472 472 472 472 472 472 472 472 472 472 472 472 472
469 469 469 469 469 469 40 472 472 472 472 472 472 472 472 472 472 472 472 472 472 46 407 407 407 17 70 472 472 472 472 472 472 472 472 472 472 472 472 472 472 472 472 472 472 472 472 472 472 472
469 469 469 467 469 469 469 12 12 13 472 472 472 472 472 472 472 472 472 472 472 68 18 69 69 70 472 472 472 472 472 472 472 472 472 472 472 472 472 472 472 472 472 472 472 472 472 472 472 472
469 468 469 469 469 469 469 469 469 469 13 472 472 472 472 472 472 472 472 472 472 472 472 472 472 472 472 472 472 472 472 472 472 472 472 472 472 472 472 472 472 472 472 472 472 472 472 472 472 472
469 469 469 469 469 469 469 467 469 469 40 472 472 472 472 472 472 472 472 472 472 472 472 472 472 472 472 472 472 472 472 472 472 472 472 472 472 472 472 472 472 472 472 472 472 472 472 472 472 472
469 469 467 469 469 469 469 469 469 469 62 13 472 472 472 472 472 472 472 472 472 472 472 472 472 472 472 472 472 472 472 472 472 472 472 472 472 472 472 472 472 472 472 472 472 472 472 472 472 472
469 469 469 469 469 469 469 469 469 469 468 40 472 472 472 472 472 472 472 472 472 472 472 472 472 472 472 472 472 472 472 472 472 472 472 472 472 472 472 472 472 472 472 472 472 472 472 472 472 472
467 469 468 469 469 467 469 469 469 469 469 469 13 472 472 472 472 472 472 472 472 472 472 472 472 472 472 472 472 472 472 472 472 472 472 472 472 472 472 472 472 472 472 472 472 472 472 472 472 472
469 467 469 469 469 469 469 469 469 467 469 469 40 472 472 472 472 472 472 472 472 472 472 472 472 472 472 472 472 472 472 472 472 472 472 472 472 472 472 472 472 472 472 472 472 472 472 472 472 472
469 469 468 469 467 469 469 469 468 469 469 469 40 472 472 472 472 472 472 472 472 472 472 472 472 472 472 472 472 472 472 472 472 472 472 472 472 472 472 472 472 472 472 472 472 472 472 472 472 472
