0 0 0 0 0 0 0 0 0 0 0 0 0 0 0 0 0 0 23 24 24 76 0 0 52 0 0 0 0 301 0 0 0 0 0 0 0 0 0 0 0 0 413 0 0 0 0 0 416 0
0 0 0 0 0 0 0 0 0 0 0 0 0 0 0 0 23 24 76 0 0 0 0 0 52 0 0 0 0 301 0 0 0 0 0 0 0 0 0 0 0 386 451 0 0 0 0 389 454 0
0 23 24 24 24 24 24 24 24 24 24 24 24 24 24 24 76 0 0 0 0 0 0 0 52 167 0 0 0 328 0 0 0 0 0 0 0 0 386 450 450 451 0 0 0 389 390 454 0 0
0 50 0 0 0 0 0 0 0 0 0 0 0 0 0 0 0 0 0 0 20 78 78 78 79 301 0 0 0 220 0 0 0 0 0 0 0 0 424 0 0 0 0 0 389 454 0 0 0 0
0 50 0 0 0 0 0 0 0 0 0 0 0 0 0 0 0 0 20 78 79 0 0 0 0 301 0 0 0 220 0 0 0 0 0 386 450 450 451 0 0 0 0 389 454 0 0 0 0 0
0 50 0 0 20 78 78 78 78 78 78 78 78 78 78 78 78 78 79 167 0 0 0 0 0 354 354 353 354 247 0 0 0 0 386 451 0 0 0 0 0 389 390 454 0 0 0 0 0 0
0 50 0 0 52 0 167 0 0 0 0 0 0 0 0 0 0 0 0 328 0 0 0 0 0 220 0 0 0 0 0 0 386 387 451 0 0 0 0 0 389 454 0 0 0 0 0 0 0 0
0 50 0 0 52 0 301 0 0 0 0 0 0 0 0 0 0 0 0 220 0 0 0 0 0 220 0 0 0 386 387 387 451 0 0 0 0 389 390 390 454 0 0 0 0 0 0 0 0 0
0 50 0 0 52 0 110 111 110 111 110 111 110 111 110 111 110 111 110 301 354 353 354 353 354 247 0 386 387 451 0 0 0 0 0 389 390 454 0 0 0 0 0 0 0 0 0 0 0 0
0 50 0 0 52 0 301 0 0 0 0 424 0 0 0 0 0 0 0 301 0 0 0 0 0 386 387 451 0 0 0 0 389 390 390 454 0 0 0 0 0 0 0 0 0 0 0 0 0 0
0 50 0 0 52 0 301 0 0 386 450 451 0 0 0 0 0 0 0 301 0 0 0 0 386 451 0 389 390 390 390 390 454 0 0 0 0 0 0 0 0 0 0 0 0 0 0 0 0 0
0 50 0 0 52 0 301 0 0 413 0 0 0 0 0 0 0 0 0 301 0 0 0 0 424 0 389 454 0 0 0 0 0 0 0 0 0 0 0 0 0 0 0 0 0 0 0 0 0 0
0 50 0 0 52 0 301 0 0 413 0 0 0 0 0 0 0 0 0 387 387 388 0 386 451 0 416 0 0 0 0 0 0 0 0 0 0 0 0 0 0 0 0 0 0 0 0 0 0 0
0 50 0 0 52 0 301 0 386 451 0 0 0 0 0 0 0 0 89 90 0 449 387 0 0 389 454 0 0 0 0 0 0 0 0 0 0 0 0 0 0 0 0 0 0 0 0 0 0 0
75 76 0 0 52 0 301 0 413 0 0 0 0 0 0 0 0 0 116 117 0 0 0 0 0 416 0 0 0 0 0 0 0 0 0 0 0 0 0 0 0 0 0 0 0 0 0 0 0 0
0 0 0 0 52 0 301 450 451 0 0 0 0 0 0 0 0 0 143 144 0 0 0 0 389 454 0 0 0 0 0 0 0 0 0 0 0 0 0 0 0 0 0 0 0 0 0 0 0 0
0 0 0 20 79 0 301 0 0 0 0 0 0 0 0 0 0 0 167 328 0 0 0 0 443 400 0 0 0 0 0 0 0 0 0 0 0 0 0 0 0 0 0 0 0 0 0 0 0 0
21 21 21 79 0 0 301 0 0 0 0 0 0 0 0 0 0 0 301 247 0 0 0 0 0 427 0 0 0 0 0 0 0 0 0 0 0 0 0 0 0 0 0 0 0 0 0 0 0 0
0 0 0 0 0 0 301 0 0 0 0 0 0 0 0 0 0 0 301 0 0 0 0 0 0 443 400 0 0 0 0 0 0 0 0 0 0 0 0 0 0 0 0 0 0 0 0 0 0 0
0 0 0 0 0 0 301 0 0 0 0 0 0 0 0 0 0 167 301 0 0 0 0 0 0 0 427 0 0 0 0 0 0 0 0 0 0 0 0 0 0 0 0 0 0 0 0 0 0 0
0 0 0 0 0 0 221 272 274 0 0 0 0 0 0 0 0 354 355 0 0 0 0 0 0 0 0 7 0 0 0 5 0 0 0 0 0 0 7 0 0 0 0 0 0 0 0 0 0 5
0 0 0 0 0 0 0 0 301 0 0 0 0 0 0 0 0 194 0 0 0 0 0 0 0 0 0 55 0 0 0 58 284 283 284 283 283 284 28 0 0 0 0 0 0 0 0 0 0 31
0 0 0 0 0 0 0 0 301 0 0 0 0 0 0 0 0 110 110 110 110 110 110 110 110 110 110 110 0 0 0 85 0 0 0 0 0 0 28 0 0 0 0 0 0 0 0 0 0 110
0 0 0 0 0 0 0 0 301 0 0 0 0 0 0 0 0 194 0 0 0 0 0 0 0 0 0 109 110 110 110 264 265 264 265 264 264 265 28 0 0 0 0 0 0 0 0 0 0 31
0 0 0 0 0 0 0 0 301 0 0 0 0 0 0 0 0 301 0 0 0 0 0 0 0 0 0 0 0 0 0 0 0 0 0 0 0 0 55 7 0 0 0 0 0 0 0 0 0 31
0 0 0 0 0 0 0 0 301 0 0 0 0 0 0 0 0 194 0 0 0 0 0 0 0 0 0 0 0 0 0 0 0 0 0 0 0 0 82 28 0 0 0 0 0 0 0 0 0 31
0 0 0 0 0 167 0 0 328 0 0 0 0 0 0 0 0 301 0 0 0 0 0 0 0 0 0 0 0 0 0 0 0 0 0 0 0 0 109 110 0 0 0 0 0 0 0 0 0 31
0 0 0 167 0 328 0 0 85 0 0 0 0 0 0 0 0 301 0 0 0 0 0 0 0 0 0 0 0 0 0 0 0 0 0 0 0 0 0 55 0 0 7 0 0 0 0 5 0 58
0 0 0 328 0 0 0 110 112 0 0 0 0 0 0 0 167 328 0 0 0 0 0 0 0 0 0 0 0 0 0 0 0 0 0 0 0 0 0 82 0 0 55 0 0 0 0 58 0 85
0 0 0 0 0 0 298 0 0 0 0 0 0 0 0 0 301 85 0 0 0 0 0 0 0 0 0 0 0 0 0 0 0 0 0 0 0 0 0 109 110 111 110 0 0 0 0 110 110 112
0 0 0 0 0 354 354 0 169 0 0 0 0 0 0 0 301 85 0 0 0 0 0 0 0 0 0 0 0 0 0 647 649 0 0 0 0 0 0 0 0 0 109 110 111 110 111 112 0 0
0 0 0 354 353 247 82 0 298 0 0 0 0 167 0 0 111 112 0 0 0 0 0 0 0 0 0 0 0 0 0 647 649 0 0 0 0 0 0 0 0 0 0 0 0 0 0 0 0 0
353 354 353 247 0 0 82 0 325 0 0 0 0 328 0 0 85 0 0 0 0 0 0 0 0 0 0 0 0 0 0 647 649 0 0 0 0 0 0 0 0 0 0 0 0 0 0 0 0 0
0 0 0 0 0 0 109 110 111 0 0 0 0 0 0 0 85 0 0 0 0 0 0 0 0 0 0 0 0 0 0 659 661 0 0 0 0 0 0 0 0 0 0 0 0 0 0 0 0 0
0 0 0 0 0 0 0 0 82 0 0 0 0 111 111 111 112 0 0 0 0 0 0 0 0 0 0 0 0 0 0 0 0 0 0 0 0 0 0 0 0 0 0 0 0 0 0 0 0 0
0 0 0 0 0 0 0 0 109 110 111 110 111 112 0 0 0 0 0 0 0 0 0 0 0 0 0 0 0 0 0 0 0 0 0 0 0 0 0 0 0 0 0 0 0 0 0 0 0 0
0 0 0 0 0 0 0 0 0 0 0 0 0 0 0 0 0 0 0 0 0 0 0 0 0 0 0 0 0 0 0 0 0 0 0 0 0 0 0 0 0 0 0 0 0 0 0 0 0 0
0 0 0 0 0 0 0 0 0 0 0 0 0 0 0 0 0 0 0 0 0 0 0 0 0 0 0 0 0 0 0 0 0 0 0 0 0 0 0 0 0 0 0 0 0 0 0 0 0 0
0 0 0 0 0 0 0 0 0 0 0 0 0 0 0 0 0 0 0 0 0 0 0 0 0 0 0 0 0 0 0 0 0 0 0 0 0 0 0 0 0 0 0 0 0 0 0 0 0 0
0 0 0 0 0 0 0 0 0 0 0 0 0 0 0 0 0 0 0 0 0 0 0 0 0 0 0 0 0 0 0 0 0 0 0 0 0 0 0 0 0 0 0 0 0 0 0 0 0 0
0 0 0 0 0 0 0 0 0 0 0 0 0 0 0 0 0 0 0 0 0 0 0 0 0 0 0 0 0 0 0 0 0 0 0 0 0 0 0 0 0 0 0 0 0 0 0 0 0 0
0 0 0 0 0 0 0 0 0 0 0 0 0 0 0 0 0 0 0 0 0 0 0 0 0 0 0 0 0 0 0 0 0 0 0 0 0 0 0 0 0 0 0 0 0 0 0 0 0 0
0 0 0 0 0 0 0 0 0 0 0 0 0 0 0 0 0 0 0 0 0 0 0 0 0 0 0 0 0 0 0 0 0 0 0 0 0 0 0 0 0 0 0 0 0 0 0 0 0 0
0 0 0 0 0 0 0 0 0 0 0 0 0 0 0 0 0 0 0 0 0 0 0 0 0 0 0 0 0 0 0 0 0 0 0 0 0 0 0 0 0 0 0 0 0 0 0 0 0 0
0 0 0 0 0 0 0 0 0 0 0 0 0 0 0 0 0 0 0 0 0 0 0 0 0 0 0 0 0 0 0 0 0 0 0 0 0 0 0 0 0 0 0 0 0 0 0 0 0 0
0 0 0 0 0 0 0 0 0 0 0 0 0 0 0 0 0 0 0 0 0 0 0 0 0 0 0 0 0 0 0 0 0 0 0 0 0 0 0 0 0 0 0 0 0 0 0 0 0 0
0 0 0 0 0 0 0 0 0 0 0 0 0 0 0 0 0 0 0 0 0 0 0 0 0 0 0 0 0 0 0 0 0 0 0 0 0 0 0 0 0 0 0 0 0 0 0 0 0 0
0 0 0 0 0 0 0 0 0 0 0 0 0 0 0 0 0 0 0 0 0 0 0 0 0 0 0 0 0 0 0 0 0 0 0 0 0 0 0 0 0 0 0 0 0 0 0 0 0 0
0 0 0 0 0 0 0 0 0 0 0 0 0 0 0 0 0 0 0 0 0 0 0 0 0 0 0 0 0 0 0 0 0 0 0 0 0 0 0 0 0 0 0 0 0 0 0 0 0 0
0 0 0 0 0 0 0 0 0 0 0 0 0 0 0 0 0 0 0 0 0 0 0 0 0 0 0 0 0 0 0 0 0 0 0 0 0 0 0 0 0 0 0 0 0 0 0 0 0 0
