0 0 0 0 0 0 0 0 0 0 0 0 0 0 0 0 0 0 23 24
0 0 0 0 0 0 0 0 0 0 0 0 0 0 0 0 23 24 76 0
0 23 24 24 24 24 24 24 24 24 24 24 24 24 24 24 76 0 0 0
0 50 0 0 0 0 0 0 0 0 0 0 0 0 0 0 0 0 0 0
0 50 0 0 0 0 0 0 0 0 0 0 0 0 0 0 0 0 20 78
0 50 0 0 20 78 78 78 78 78 78 78 78 78 78 78 78 78 79 167
0 50 0 0 52 0 167 0 0 0 0 0 0 0 0 0 0 0 0 328
0 50 0 0 52 0 301 0 0 0 0 0 0 0 0 0 0 0 0 220
0 50 0 0 52 0 301 109 110 111 110 111 110 111 110 111 110 111 112 301
0 50 0 0 52 0 301 0 0 0 0 0 0 0 0 0 0 0 0 301
0 50 0 0 52 0 301 0 0 0 0 0 0 0 0 0 0 0 0 301
0 50 0 0 52 0 301 0 0 0 0 0 0 0 0 0 0 0 0 301
0 50 0 0 52 0 301 0 0 0 0 0 0 0 0 0 0 0 0 301
0 50 0 0 52 0 301 0 0 0 0 0 0 0 0 0 0 0 0 301
75 76 0 0 52 0 301 0 0 0 0 0 0 0 0 0 0 0 0 301
0 0 0 0 52 0 301 0 0 0 0 0 0 0 0 0 0 0 0 301
0 0 0 20 79 0 301 0 0 0 0 0 0 0 0 0 0 0 0 328
21 21 21 79 0 0 301 0 0 0 0 0 0 0 0 0 0 0 167 355
0 0 0 0 0 0 310 0 0 0 0 0 0 0 0 0 0 0 301 0
0 0 0 0 0 0 310 0 0 0 0 0 0 0 0 0 0 0 301 0
0 0 0 0 0 0 310 0 0 0 0 0 0 0 0 0 0 0 301 0
